A	AH
A(2)	EY
AIN'T	EY N T
ALL-STAR	AO L S T AA R
AN	AE N
AN(2)	AH N
GAME	G EY M
GET	G EH T
GET(2)	G IH T
GO	G OW
GONNA	G AA N AH
HEY	HH EY
I	AY
IN	IH N
IS	IH Z
ME	M IY
NOW	N AW
ON	AA N
ON(2)	AO N
ONCE	W AH N S
PAID	P EY D
PLAY	P L EY
ROCK	R AA K
ROLL	R OW L
SHARPEST	SH AA R P AH S T
SHED	SH EH D
SHOW	SH OW
SOMEBODY	S AH M B AA D IY
SOMEBODY(2)	S AH M B AH D IY
STAR	S T AA R
THE	DH AH
THE(2)	DH IY
TOLD	T OW L D
TOOL	T UW L
WORLD	W ER L D
YOU'RE	Y UH R
YOU'RE(2)	Y UW R
YOUR	Y AO R
YOUR(2)	Y UH R
